"aC" = (/obj/machinery/atmospherics/pipe/simple/scrubbers/hidden/layer4,/turf/open/floor/plating,/area/space)
"bg" = (/obj/effect/spawner/structure/window/shuttle,/turf/open/floor/plasteel/tech,/area/space)
"bX" = (/obj/machinery/atmospherics/pipe/simple/scrubbers/hidden/layer4{dir = 8},/turf/open/floor/plasteel/tech,/area/space)
"cj" = (/obj/machinery/door/airlock/engineering{name = "Engineering"},/turf/open/floor/plating/catwalk_floor,/area/hangar)
"cI" = (/turf/closed/wall/r_wall,/area/space)
"dh" = (/obj/effect/turf_decal/corner/opaque/solgovgold/half,/turf/open/floor/plasteel/dark,/area/space)
"eE" = (/obj/effect/turf_decal/corner/opaque/solgovgold/three_quarters{dir = 8},/turf/open/floor/plasteel/dark,/area/space)
"eH" = (/obj/effect/turf_decal/corner/opaque/solgovgold/half,/obj/machinery/atmospherics/pipe/simple/scrubbers/hidden/layer4,/turf/open/floor/plasteel/dark,/area/space)
"fp" = (/turf/open/floor/plasteel/dark,/area/space)
"fx" = (/obj/effect/turf_decal/corner/opaque/solgovgold/half{dir = 8},/turf/open/floor/plasteel/dark,/area/space)
"gg" = (/obj/effect/turf_decal/corner/opaque/solgovgold/three_quarters{dir = 1},/obj/machinery/atmospherics/pipe/simple/scrubbers/hidden/layer4,/turf/open/floor/plasteel/tech,/area/hangar)
"gU" = (/obj/machinery/atmospherics/pipe/simple/scrubbers/hidden/layer4{dir = 10},/turf/open/floor/plating,/area/space)
"hm" = (/obj/machinery/door/airlock/engineering{dir = 4; name = "Engineering"},/obj/machinery/door/airlock/engineering{dir = 4; name = "Engineering"},/turf/open/floor/plasteel/tech/grid,/area/space)
"jk" = (/obj/effect/turf_decal/siding/thinplating/dark,/turf/open/floor/plasteel/dark,/area/hangar)
"lZ" = (/turf/template_noop,/area/space)
"mb" = (/obj/machinery/atmospherics/pipe/simple/scrubbers/hidden/layer4{dir = 4},/turf/open/floor/plating,/area/space)
"mn" = (/obj/machinery/door/airlock/engineering{dir = 4; name = "Engineering"},/turf/open/floor/plating,/area/space)
"mW" = (/turf/closed/wall/mineral/titanium/nodiagonal,/area/hangar)
"nt" = (/obj/machinery/door/airlock/science{dir = 8},/turf/open/floor/plasteel/white,/area/space)
"nw" = (/obj/machinery/atmospherics/pipe/simple/scrubbers/hidden/layer4,/turf/open/floor/plasteel/dark,/area/space)
"nQ" = (/obj/machinery/door/airlock/engineering{dir = 4; name = "Engineering"},/turf/open/floor/plasteel/tech/grid,/area/space)
"nX" = (/turf/open/floor/plasteel/dark,/area/hangar)
"oc" = (/obj/effect/turf_decal/corner/opaque/solgovgold,/turf/open/floor/plasteel/tech,/area/hangar)
"ok" = (/obj/effect/turf_decal/siding/thinplating/dark{dir = 4},/obj/effect/turf_decal/siding/thinplating/dark,/turf/open/floor/plasteel/dark,/area/hangar)
"oF" = (/obj/machinery/door/airlock/engineering{name = "Engineering"},/turf/open/floor/plating,/area/space)
"oT" = (/obj/machinery/door/airlock/maintenance_hatch,/turf/open/floor/plasteel/dark,/area/space)
"pe" = (/obj/effect/turf_decal/corner/opaque/solgovgold/half,/turf/open/floor/plasteel/tech,/area/hangar)
"qc" = (/obj/machinery/atmospherics/pipe/simple/scrubbers/hidden/layer4{dir = 9},/turf/open/floor/plating,/area/space)
"qp" = (/obj/machinery/atmospherics/pipe/simple/scrubbers/hidden/layer4{dir = 9},/turf/open/floor/plasteel/tech,/area/space)
"qy" = (/turf/open/floor/plating,/area/space)
"qE" = (/obj/effect/turf_decal/corner/opaque/solgovgold/half{dir = 4},/turf/open/floor/plasteel/dark,/area/space)
"sk" = (/obj/machinery/door/airlock/engineering{name = "Engineering"},/turf/open/floor/plasteel/tech,/area/space)
"sD" = (/turf/closed/wall/mineral/titanium/nodiagonal,/area/space)
"tD" = (/obj/effect/turf_decal/techfloor/orange{dir = 1},/turf/open/floor/plasteel/tech,/area/hangar)
"ut" = (/obj/effect/turf_decal/corner/opaque/solgovgold/half{dir = 8},/obj/machinery/atmospherics/pipe/simple/scrubbers/hidden/layer4,/turf/open/floor/plasteel/tech,/area/hangar)
"vy" = (/obj/machinery/door/poddoor/shuttledock{dir = 4},/turf/open/floor/plating,/area/hangar)
"wm" = (/obj/effect/turf_decal/dept,/turf/open/floor/plasteel/tech,/area/hangar)
"xu" = (/obj/effect/turf_decal/siding/thinplating/dark{dir = 8},/turf/open/floor/plasteel/dark,/area/hangar)
"xW" = (/obj/structure/railing,/turf/open/floor/plasteel/white,/area/hangar)
"yv" = (/obj/effect/turf_decal/corner/opaque/solgovgold/three_quarters,/turf/open/floor/plasteel/dark,/area/space)
"yE" = (/obj/structure/railing{dir = 4},/obj/effect/turf_decal/corner/opaque/solgovgold/half{dir = 8},/obj/machinery/atmospherics/pipe/simple/scrubbers/hidden/layer4,/turf/open/floor/plasteel/tech,/area/hangar)
"zt" = (/obj/structure/railing{dir = 4},/obj/effect/turf_decal/corner/opaque/solgovgold/three_quarters{dir = 4},/obj/machinery/atmospherics/pipe/simple/scrubbers/hidden/layer4,/turf/open/floor/plasteel/tech,/area/hangar)
"zJ" = (/obj/machinery/atmospherics/pipe/simple/scrubbers/hidden/layer4{dir = 1},/turf/open/floor/plasteel/tech,/area/space)
"Al" = (/turf/open/floor/plasteel/tech/grid,/area/space)
"BR" = (/obj/effect/spawner/structure/window/shuttle,/obj/effect/spawner/structure/window/shuttle,/turf/open/floor/plasteel/tech,/area/space)
"BX" = (/obj/effect/turf_decal/siding/thinplating/dark,/obj/effect/turf_decal/siding/thinplating/dark{dir = 8},/turf/open/floor/plasteel/dark,/area/hangar)
"CF" = (/obj/effect/turf_decal/corner/opaque/solgovgold/three_quarters{dir = 4},/turf/open/floor/plasteel/dark,/area/space)
"CV" = (/obj/effect/turf_decal/corner/opaque/solgovgold/three_quarters,/turf/open/floor/plasteel/tech,/area/hangar)
"DI" = (/obj/machinery/atmospherics/pipe/simple/scrubbers/hidden/layer4{dir = 5},/turf/open/floor/plating,/area/space)
"EH" = (/obj/effect/turf_decal/corner/opaque/solgovgold/three_quarters{dir = 1},/turf/open/floor/plasteel/dark,/area/space)
"Ii" = (/obj/machinery/door/airlock/engineering{name = "Engineering"},/obj/machinery/atmospherics/pipe/simple/scrubbers/hidden/layer4,/turf/open/floor/plating,/area/space)
"IE" = (/turf/open/floor/plasteel/stairs/left,/area/hangar)
"IF" = (/obj/machinery/door/airlock/maintenance_hatch,/turf/open/floor/plasteel/tech,/area/space)
"Je" = (/turf/closed/wall/r_wall,/area/hangar)
"JI" = (/obj/structure/shuttle/engine/heater,/turf/open/floor/plasteel/dark,/area/space)
"Kq" = (/obj/effect/turf_decal/corner/opaque/solgovgold/half{dir = 1},/turf/open/floor/plasteel/dark,/area/space)
"KS" = (/turf/open/floor/plasteel/tech,/area/space)
"Ld" = (/turf/open/floor/plasteel/white,/area/hangar)
"LM" = (/obj/machinery/door/airlock/engineering{name = "Engineering"},/obj/machinery/atmospherics/pipe/simple/scrubbers/hidden/layer4,/turf/open/floor/plating/catwalk_floor,/area/hangar)
"Ns" = (/turf/open/floor/plasteel/tech,/area/hangar)
"Nv" = (/obj/machinery/door/airlock/engineering{name = "Engineering"},/obj/machinery/atmospherics/pipe/simple/scrubbers/hidden/layer4{dir = 1},/turf/open/floor/plating,/area/space)
"PB" = (/turf/open/floor/plasteel/white,/area/space)
"PD" = (/obj/machinery/door/airlock/science,/turf/open/floor/plasteel/white,/area/hangar)
"QL" = (/obj/machinery/atmospherics/pipe/simple/scrubbers/hidden/layer4{dir = 6},/turf/open/floor/plating,/area/space)
"Vz" = (/obj/machinery/door/poddoor/shuttledock{dir = 4},/turf/closed/wall/r_wall,/area/hangar)
"WN" = (/obj/effect/turf_decal/siding/thinplating/dark{dir = 4},/turf/open/floor/plasteel/dark,/area/hangar)
"WV" = (/obj/structure/shuttle/engine/heater,/turf/open/floor/plasteel/tech,/area/space)
"XV" = (/obj/effect/turf_decal/corner/opaque/solgovgold/half{dir = 4},/turf/open/floor/plasteel/tech,/area/hangar)
"ZP" = (/obj/machinery/atmospherics/pipe/simple/scrubbers/hidden/layer4{dir = 8},/turf/open/floor/plating,/area/space)
"ZT" = (/obj/structure/shuttle/engine/huge,/turf/template_noop,/area/space)

(1,1,1) = {"
lZlZlZlZlZlZlZlZlZlZlZlZlZlZlZlZlZlZlZlZlZlZlZlZlZlZlZlZlZlZlZlZlZlZlZlZlZlZlZlZlZlZlZlZlZlZlZlZlZlZlZlZlZlZlZlZlZlZlZlZlZlZlZlZlZlZlZlZlZlZlZlZlZlZlZlZlZlZlZlZlZlZlZlZlZlZlZlZlZlZ
lZlZlZlZlZlZlZlZlZlZlZlZlZlZlZlZlZlZlZlZlZlZlZlZlZlZlZlZlZlZlZlZlZlZlZlZlZlZlZlZlZlZlZlZlZlZlZlZlZlZlZlZlZlZlZlZlZlZlZlZlZlZlZlZlZlZlZlZlZlZlZlZlZlZlZlZlZlZlZlZlZlZlZlZlZlZlZlZlZlZ
lZlZlZlZlZlZlZlZlZlZlZlZlZlZlZlZlZlZlZlZlZlZlZlZlZlZlZlZlZlZlZlZlZlZlZlZlZlZlZlZlZlZlZlZlZlZlZlZlZlZlZlZlZlZlZlZlZlZlZlZlZlZlZlZlZlZlZlZlZlZlZlZlZlZlZlZlZlZlZlZlZlZlZlZlZlZlZlZlZlZ
lZlZlZlZlZlZlZlZlZlZlZlZlZlZlZlZlZlZlZlZlZlZlZlZlZlZlZlZlZlZlZlZlZlZlZlZlZlZlZlZlZlZlZlZlZlZlZlZlZlZlZlZlZlZlZlZlZlZlZlZlZlZlZlZlZlZlZlZlZlZlZlZlZlZlZlZlZlZlZlZlZlZlZlZlZlZlZlZlZlZ
lZlZlZlZlZlZlZlZlZlZlZlZlZlZlZlZlZlZlZlZlZlZlZlZlZlZlZlZlZlZlZlZlZlZlZlZlZlZlZlZlZlZlZlZlZlZlZlZlZlZlZlZlZlZlZlZlZlZlZlZlZlZlZlZlZlZlZlZlZlZlZlZlZlZlZlZlZlZlZlZlZlZlZlZlZlZlZlZlZlZ
lZlZlZlZlZlZlZlZlZlZlZlZlZlZlZlZlZlZlZlZlZlZlZlZlZlZlZlZlZlZlZlZlZlZlZlZlZlZlZlZlZlZlZlZlZlZlZlZlZlZlZlZlZlZlZlZlZlZlZlZlZlZlZlZlZlZlZlZlZlZlZlZlZlZlZlZlZlZlZlZlZlZlZlZlZlZlZlZlZlZ
lZlZlZlZlZlZlZlZlZlZlZlZlZlZlZlZlZlZlZlZlZlZlZlZlZlZlZlZlZlZlZlZlZlZlZlZlZlZlZlZlZlZlZlZlZlZlZlZlZlZlZlZlZlZlZlZlZlZlZlZlZlZlZlZlZlZlZlZlZlZlZlZlZlZlZlZlZlZlZlZlZlZlZlZlZlZlZlZlZlZ
lZlZlZlZlZlZlZlZlZlZlZlZlZlZlZlZlZlZlZlZlZlZlZlZlZlZlZlZlZlZlZlZlZlZlZlZlZlZlZlZlZlZlZlZlZlZlZlZlZlZlZlZlZlZlZlZlZlZlZlZlZlZlZlZlZlZlZlZlZlZlZlZlZlZlZlZlZlZlZlZlZlZlZlZlZlZlZlZlZlZ
lZlZlZlZlZlZlZlZlZlZlZlZlZlZlZlZlZlZlZlZlZlZlZlZlZlZlZlZlZlZlZlZlZlZlZlZlZlZlZlZlZlZlZlZlZlZlZlZlZlZlZlZlZlZlZlZlZlZlZlZlZlZlZlZlZlZlZlZlZlZlZlZlZlZlZlZlZlZlZlZlZlZlZlZlZlZlZlZlZlZ
lZlZlZlZlZlZlZlZlZlZlZlZlZlZlZlZlZlZlZlZlZlZlZlZlZlZlZlZlZlZlZlZlZlZlZlZlZlZlZlZlZlZlZlZlZlZlZlZlZlZlZlZlZlZlZlZlZlZlZlZlZlZlZlZlZlZlZlZlZlZlZlZlZlZlZlZlZlZlZlZlZlZlZlZlZlZlZlZlZlZ
lZlZlZlZlZlZlZlZlZlZlZlZlZlZlZlZlZlZlZlZlZlZlZlZlZlZlZlZlZlZlZlZlZlZlZlZlZlZlZlZlZlZlZlZlZlZlZlZlZlZlZlZlZlZlZlZlZlZlZlZlZlZlZlZlZlZlZlZlZlZlZlZlZlZlZlZlZlZlZlZlZlZlZlZlZlZlZlZlZlZ
lZlZlZlZlZlZlZlZlZlZlZlZlZlZlZlZlZlZlZlZlZlZlZlZlZlZlZlZlZlZlZlZlZlZlZlZlZlZlZlZlZlZlZlZlZlZlZlZlZlZlZlZlZlZlZlZlZlZlZlZlZlZlZlZlZlZlZlZlZlZlZlZlZlZlZlZlZlZlZlZlZlZlZlZlZlZlZlZlZlZ
lZlZlZlZlZlZlZlZlZlZlZlZlZlZlZlZlZlZlZlZlZlZlZlZlZlZlZlZlZlZlZlZlZlZlZlZlZlZlZlZlZlZlZlZlZlZlZlZlZlZlZlZlZlZlZlZlZlZlZlZlZlZlZlZlZlZlZlZlZlZlZlZlZlZlZlZlZlZlZlZlZlZlZlZlZlZlZlZlZlZ
lZlZlZlZlZlZlZlZlZlZlZlZlZlZlZlZlZlZlZlZlZlZlZlZlZlZlZlZlZlZlZlZlZlZlZlZlZlZlZlZlZlZlZlZlZlZlZlZlZlZlZlZlZlZlZlZlZlZlZlZlZlZlZlZlZlZlZlZlZlZlZlZlZlZlZlZlZlZlZlZlZlZlZlZlZlZlZlZlZlZ
lZlZlZlZlZlZlZlZlZlZlZlZlZlZlZlZlZlZlZlZlZlZlZlZlZlZlZlZlZlZlZlZlZlZlZlZlZlZlZlZlZlZlZlZlZlZlZlZlZlZlZlZlZlZlZlZlZlZlZlZlZlZlZlZlZlZlZlZlZlZlZlZlZlZlZlZlZlZlZlZlZlZlZlZlZlZlZlZlZlZ
lZlZlZlZlZlZlZlZlZlZlZlZlZlZlZlZlZlZlZlZlZlZlZlZlZlZlZlZlZlZlZlZlZlZlZlZlZlZlZlZlZlZlZlZlZlZlZlZlZlZlZlZlZlZlZlZlZlZlZlZlZlZlZlZlZlZlZlZlZlZlZlZlZlZlZlZlZlZlZlZlZlZlZlZlZlZlZlZlZlZ
lZlZlZlZlZlZlZlZlZlZlZlZlZlZlZlZlZlZlZlZlZlZlZlZlZlZlZlZlZlZlZlZlZlZlZlZlZlZlZlZlZlZlZlZlZlZlZlZlZlZlZlZlZlZlZlZlZlZlZlZlZlZlZlZlZlZlZlZlZlZlZlZlZlZlZlZlZlZlZlZlZlZlZlZlZlZlZlZlZlZ
lZlZlZlZlZlZlZlZlZlZlZlZlZlZlZlZlZlZlZlZlZlZlZlZlZlZlZlZlZlZlZlZlZlZlZlZlZlZlZlZlZlZlZlZlZlZlZlZlZlZlZlZlZlZlZlZlZlZlZlZlZlZlZlZlZlZlZlZlZlZlZlZlZlZlZlZlZlZlZlZlZlZlZlZlZlZlZlZlZlZ
lZlZlZlZlZlZlZlZlZlZlZlZlZlZlZlZlZlZlZlZlZlZlZlZlZlZBRbgbglZlZlZlZlZlZlZlZlZlZlZlZlZlZlZlZlZlZlZlZlZlZlZlZlZlZlZlZlZlZlZlZlZlZlZlZlZlZlZlZlZlZlZlZlZlZlZlZlZlZlZlZlZlZlZlZlZlZlZlZlZ
lZlZlZlZlZlZlZlZlZlZlZlZlZlZlZlZlZlZlZlZlZlZlZlZsDbgBRKSbgBRsDlZlZlZlZlZlZlZlZlZlZlZlZlZlZlZlZlZlZlZlZlZlZlZlZlZlZlZlZlZlZlZlZlZlZlZlZlZlZlZlZlZlZlZlZlZlZlZlZlZlZlZlZlZlZlZlZlZlZlZ
lZlZlZlZlZlZlZlZlZlZlZlZlZlZlZlZlZlZlZlZlZlZlZlZsDKSKSKSKSKSsDsDcIcIcIcIcIcIcIcIlZlZlZlZlZlZlZlZlZlZlZlZlZlZlZlZlZlZlZlZlZlZlZlZlZlZlZlZlZlZlZlZlZlZlZlZlZlZlZlZlZlZlZlZlZlZlZlZlZlZ
lZlZlZlZlZlZlZlZlZlZlZlZlZlZlZlZlZlZlZlZlZlZlZlZsDKSKSKSKSKSsDQLmbmbmbmbmbmbgUcIcIcIcIlZlZlZlZlZlZlZlZlZlZlZlZlZlZlZlZlZlZlZlZlZlZlZlZlZlZlZlZlZlZlZlZlZlZlZlZlZlZlZlZlZlZlZlZlZlZlZ
lZlZlZlZlZlZlZlZlZlZlZlZlZlZlZlZlZlZlZlZlZlZlZlZsDKSKSKSKSKSsDNvsDsDsDsDsDsDDImbmbgUcIcIcIlZlZlZlZlZlZlZlZlZlZlZlZlZlZlZlZlZlZlZlZlZlZlZlZlZlZlZlZlZlZlZlZlZlZlZlZlZlZlZlZlZlZlZlZlZ
lZlZlZlZlZlZlZlZlZlZlZlZlZlZlZlZlZlZlZlZlZlZlZsDsDsDKSKSKSKSKSzJsDKSKSKSKSsDsDsDsDDImbgUcIcIcIlZlZlZlZlZlZlZlZlZlZlZlZlZlZlZlZlZlZlZlZlZlZlZlZlZlZlZlZlZlZlZlZlZlZlZlZlZlZlZlZlZlZlZ
lZlZlZlZlZlZlZlZlZlZlZlZlZlZlZlZlZlZlZlZcIcIcIcIQLmnbXbXbXbXbXqpsDKSKSKSKSKSKSKSsDsDsDDIgUfpcIlZlZlZlZlZlZlZlZlZlZlZlZlZlZlZlZlZlZlZlZlZlZlZlZlZlZlZlZlZlZlZlZlZlZlZlZlZlZlZlZlZlZlZ
lZlZlZlZlZlZlZlZlZlZlZlZlZlZlZlZlZlZcIcIcIQLZPZPqcsDsDsDoFsDsDsDsDKSKSKSKSKSKSKSKSKSsDAlaCfpcIlZlZlZlZlZlZlZlZlZlZlZlZlZlZlZlZlZlZlZlZlZlZlZlZlZlZlZlZlZlZlZlZlZlZlZlZlZlZlZlZlZlZlZ
lZlZlZlZlZlZlZlZlZlZlZlZlZlZlZlZcIcIcIQLZPqcsDsDsDsDfpfpfpfpfpfpsDKSKSKSKSKSKSKSKSKSsDAlaCfpcIlZlZlZlZlZlZlZlZlZlZlZlZlZlZlZlZlZlZlZlZlZlZlZlZlZlZlZlZlZlZlZlZlZlZlZlZlZlZlZlZlZlZlZ
lZlZlZlZlZlZlZlZlZlZlZlZlZlZlZlZcIQLZPqcsDsDsDfpfpfpfpfpfpfpfpfpsDsDsDsDsDsksDsDsDsDsDAlaCfpcIlZlZlZlZlZlZlZlZlZlZlZlZlZlZlZlZlZlZlZlZlZlZlZlZlZlZlZlZlZlZlZlZlZlZlZlZlZlZlZlZlZlZlZ
lZlZlZlZlZlZlZlZlZlZlZlZlZlZlZlZcIaCsDsDsDfpfpfpfpfpfpfpfpfpfpfpfpfpfpfpfpfpfpfpfpfpsDAlaCfpcIlZlZlZlZlZlZlZlZlZlZlZlZlZlZlZlZlZlZlZlZlZlZlZlZlZlZlZlZlZlZlZlZlZlZlZlZlZlZlZlZlZlZlZ
lZlZlZlZlZlZlZlZlZlZlZlZlZlZlZlZcIaCsDfpfpfpfpfpfpfpfpfpfpfpfpfpfpfpfpfpfpfpfpfpfpfpsDAlaCfpcIlZlZlZlZlZlZlZlZlZlZlZlZlZlZlZlZlZlZlZlZlZlZlZlZlZlZlZlZlZlZlZlZlZlZlZlZlZlZlZlZlZlZlZ
lZlZlZlZlZlZlZlZlZlZlZlZlZlZlZlZcIaCsDfpfpfpfpfpfpfpfpfpfpfpfpfpfpfpfpfpfpfpfpfpfpfpsDAlaCfpcIlZlZlZlZlZlZlZlZlZlZlZlZlZlZlZlZlZlZlZlZlZlZlZlZlZlZlZlZlZlZlZlZlZlZlZlZlZlZlZlZlZlZlZ
lZlZlZlZlZlZlZlZlZlZlZlZlZlZlZlZcIaCsDfpfpfpfpfpfpfpfpfpfpfpfpfpfpfpfpfpfpfpfpfpfpfpsDAlaCfpcIlZlZlZlZlZlZlZlZlZlZlZlZlZlZlZlZlZlZlZlZlZlZlZlZlZlZlZlZlZlZlZlZlZlZlZlZlZlZlZlZlZlZlZ
lZlZlZlZlZlZlZlZlZlZlZlZlZlZlZlZcIaCsDfpfpfpfpfpsDsDsDsDsDsDsDsDsDsDsDfpfpfpfpfpfpfpsDAlaCfpcIlZlZlZlZlZlZlZlZlZlZlZlZlZlZlZlZlZlZlZlZlZlZlZlZlZlZlZlZlZlZlZlZlZlZlZlZlZlZlZlZlZlZlZ
lZlZlZlZlZlZlZlZlZlZlZlZlZlZlZlZcIaCsDfpfpfpfpfpsDPBPBPBPBPBPBPBPBPBsDfpfpfpfpfpfpfpsDAlaCfpcIlZlZlZlZlZlZlZlZlZlZlZlZlZlZlZlZlZlZlZlZlZlZlZlZlZlZlZlZlZlZlZlZlZlZlZlZlZlZlZlZlZlZlZ
lZlZlZlZlZlZlZlZlZlZlZlZlZlZlZlZcIaCsDfpfpfpfpfpsDPBPBPBPBPBPBPBPBPBsDfpfpfpfpfpfpfpsDAlaCfpcIlZlZlZlZlZlZlZlZlZlZlZlZlZlZlZlZlZlZlZlZlZlZlZlZlZlZlZlZlZlZlZlZlZlZlZlZlZlZlZlZlZlZlZ
lZlZlZlZlZlZlZlZlZlZlZlZlZlZlZlZcIaCsDfpfpfpfpfpsDPBPBPBPBPBPBPBPBPBsDfpfpfpfpfpfpfphmAlaCfpcIlZlZlZlZlZlZlZlZlZlZlZlZlZlZlZlZlZlZlZlZlZlZlZlZlZlZlZlZlZlZlZlZlZlZlZlZlZlZlZlZlZlZlZ
lZlZlZlZlZlZlZlZlZlZlZlZlZlZlZlZcIaCsDfpfpfpfpfpsDPBPBPBPBPBPBPBPBPBsDfpfpfpfpfpfpfpsDAlaCfpcIlZlZlZlZlZlZlZlZlZlZlZlZlZlZlZlZlZlZlZlZlZlZlZlZlZlZlZlZlZlZlZlZlZlZlZlZlZlZlZlZlZlZlZ
lZlZlZlZlZlZlZlZlZlZlZlZlZlZlZlZcIaCsDfpfpfpfpfpsDPBPBPBPBPBPBPBPBPBsDfpfpfpfpfpfpfpsDAlaCfpcIlZlZlZlZlZlZlZlZlZlZlZlZlZlZlZlZlZlZlZlZlZlZlZlZlZlZlZlZlZlZlZlZlZlZlZlZlZlZlZlZlZlZlZ
lZlZlZlZlZlZlZlZlZlZlZlZlZlZlZlZcIaCsDfpfpfpfpfpsDPBPBPBPBPBPBPBPBPBsDfpfpfpfpfpfpfpsDAlaCfpcIlZlZlZlZlZlZlZlZlZlZlZlZlZlZlZlZlZlZlZlZlZlZlZlZlZlZlZlZlZlZlZlZlZlZlZlZlZlZlZlZlZlZlZ
lZlZlZlZlZlZlZlZlZlZlZlZlZlZlZlZcIaCsDfpfpfpfpfpntPBPBPBPBPBPBPBPBPBntfpfpfpfpfpfpfpsDAlaCfpcIlZlZlZlZlZlZlZlZlZlZlZlZlZlZlZlZlZlZlZlZlZlZlZlZlZlZlZlZlZlZlZlZlZlZlZlZlZlZlZlZlZlZlZ
lZlZlZlZlZlZlZlZlZlZlZlZlZlZlZlZcIaCsDfpfpfpfpfpsDPBPBPBPBPBPBPBPBPBsDfpfpfpfpfpfpfpsDAlaCfpcIlZlZlZlZlZlZlZlZlZlZlZlZlZlZlZlZlZlZlZlZlZlZlZlZlZlZlZlZlZlZlZlZlZlZlZlZlZlZlZlZlZlZlZ
lZlZlZlZlZlZlZlZlZlZlZlZlZlZlZlZcIaCsDfpfpfpfpfpsDPBPBPBPBPBPBPBPBPBsDfpfpfpfpfpfpfpsDAlaCfpcIlZlZlZlZlZlZlZlZlZlZlZlZlZlZlZlZlZlZlZlZlZlZlZlZlZlZlZlZlZlZlZlZlZlZlZlZlZlZlZlZlZlZlZ
lZlZlZlZlZlZlZlZlZlZlZlZlZlZlZlZcIaCsDfpfpfpfpfpsDPBPBPBPBPBPBPBPBPBsDfpfpfpfpfpfpfpsDAlaCfpcIlZlZlZlZlZlZlZlZlZlZlZlZlZlZlZlZlZlZlZlZlZlZlZlZlZlZlZlZlZlZlZlZlZlZlZlZlZlZlZlZlZlZlZ
lZlZlZlZlZlZlZlZlZlZlZlZlZlZlZlZcIaCsDfpfpfpfpfpsDPBPBPBPBPBPBPBPBPBsDfpfpfpfpfpfpfpsDAlaCfpcIlZlZlZlZlZlZlZlZlZlZlZlZlZlZlZlZlZlZlZlZlZlZlZlZlZlZlZlZlZlZlZlZlZlZlZlZlZlZlZlZlZlZlZ
lZlZlZlZlZlZlZlZlZlZlZlZlZlZlZlZcIaCsDfpfpfpfpfpsDPBPBPBPBPBPBPBPBPBsDfpfpfpfpfpfpfpsDAlaCfpcIlZlZlZlZlZlZlZlZlZlZlZlZlZlZlZlZlZlZlZlZlZlZlZlZlZlZlZlZlZlZlZlZlZlZlZlZlZlZlZlZlZlZlZ
lZlZlZlZlZlZlZlZlZlZlZlZlZlZlZlZJeLMmWmWmWmWmWmWmWmWmWmWmWmWPDmWmWmWsDsDsDsDsksDsDsDsDAlaCfpcIlZlZlZlZlZlZlZlZlZlZlZlZlZlZlZlZlZlZlZlZlZlZlZlZlZlZlZlZlZlZlZlZlZlZlZlZlZlZlZlZlZlZlZ
lZlZlZlZlZlZlZlZlZlZlZlZlZlZlZlZVzztLdLdLdLdLdLdLdLdLdLdLdLdLdLdLdmWCFKqKqKqKqKqKqeEsDAlaCfpcIlZlZlZlZlZlZlZlZlZlZlZlZlZlZlZlZlZlZlZlZlZlZlZlZlZlZlZlZlZlZlZlZlZlZlZlZlZlZlZlZlZlZlZ
lZlZlZlZlZlZlZlZlZlZlZlZlZlZlZlZvyyELdLdLdLdLdLdLdLdLdLdLdLdLdLdLdmWfxfpfpfpfpfpfpqEsDAlaCfpcIlZlZlZlZlZlZlZlZlZlZlZlZlZlZlZlZlZlZlZlZlZlZlZlZlZlZlZlZlZlZlZlZlZlZlZlZlZlZlZlZlZlZlZ
lZlZlZlZlZlZlZlZlZlZlZlZlZlZlZlZvyyExWxWxWxWxWxWxWxWxWxWxWLdLdLdxWmWfxfpfpfpfpfpfpqEsDAlaCfpcIlZlZlZlZlZlZlZlZlZlZlZlZlZlZlZlZlZlZlZlZlZlZlZlZlZlZlZlZlZlZlZlZlZlZlZlZlZlZlZlZlZlZlZ
lZlZlZlZlZlZlZlZlZlZlZlZlZlZlZlZvyuttDtDtDtDtDtDtDtDtDtDtDIEIEIEXVmWfxfpfpfpfpfpfpqEsDAlaCfpcIlZlZlZlZlZlZlZlZlZlZlZlZlZlZlZlZlZlZlZlZlZlZlZlZlZlZlZlZlZlZlZlZlZlZlZlZlZlZlZlZlZlZlZ
lZlZlZlZlZlZlZlZlZlZlZlZlZlZlZlZvyutwmwmwmwmNswmwmwmwmNsNsxunXWNXVmWfxfpfpfpfpfpfpqEsDAlaCfpcIlZlZlZlZlZlZlZlZlZlZlZlZlZlZlZlZlZlZlZlZlZlZlZlZlZlZlZlZlZlZlZlZlZlZlZlZlZlZlZlZlZlZlZ
lZlZlZlZlZlZlZlZlZlZlZlZlZlZlZlZvyutwmwmwmwmNswmwmwmwmNsNsxunXWNXVmWfxfpfpfpfpfpfpqEsDAlaCfpcIlZlZlZlZlZlZlZlZlZlZlZlZlZlZlZlZlZlZlZlZlZlZlZlZlZlZlZlZlZlZlZlZlZlZlZlZlZlZlZlZlZlZlZ
lZlZlZlZlZlZlZlZlZlZlZlZlZlZlZlZvyutwmwmwmwmNswmwmwmwmNsNsxunXWNXVmWfxfpfpfpfpfpfpqEsDAlaCfpcIlZlZlZlZlZlZlZlZlZlZlZlZlZlZlZlZlZlZlZlZlZlZlZlZlZlZlZlZlZlZlZlZlZlZlZlZlZlZlZlZlZlZlZ
lZlZlZlZlZlZlZlZlZlZlZlZlZlZlZlZvyutwmwmwmwmNswmwmwmwmNsNsxunXWNXVmWfxfpfpfpfpfpfpqEsDAlaCfpcIlZlZlZlZlZlZlZlZlZlZlZlZlZlZlZlZlZlZlZlZlZlZlZlZlZlZlZlZlZlZlZlZlZlZlZlZlZlZlZlZlZlZlZ
lZlZlZlZlZlZlZlZlZlZlZlZlZlZlZlZvyutNsNsNsNsNsNsNsNsNsNsNsxunXWNXVmWfxfpfpfpfpfpfpqEnQAlaCfpcIlZlZlZlZlZlZlZlZlZlZlZlZlZlZlZlZlZlZlZlZlZlZlZlZlZlZlZlZlZlZlZlZlZlZlZlZlZlZlZlZlZlZlZ
lZlZlZlZlZlZlZlZlZlZlZlZlZlZlZlZvyutNsNsNsNsNsNsNsNsNsNsNsxunXWNXVmWfxfpfpfpfpfpfpqEsDAlaCfpcIlZlZlZlZlZlZlZlZlZlZlZlZlZlZlZlZlZlZlZlZlZlZlZlZlZlZlZlZlZlZlZlZlZlZlZlZlZlZlZlZlZlZlZ
lZlZlZlZlZlZlZlZlZlZlZlZlZlZlZlZvyutNsNsNsNsNsNsNsNsNsNsNsxunXWNXVmWfxfpfpfpfpfpnwqEsDAlaCfpcIlZlZlZlZlZlZlZlZlZlZlZlZlZlZlZlZlZlZlZlZlZlZlZlZlZlZlZlZlZlZlZlZlZlZlZlZlZlZlZlZlZlZlZ
lZlZlZlZlZlZlZlZlZlZlZlZlZlZlZlZvyutNsNsNsNsNsNsNsNsNsNsNsxunXWNXVmWfxfpfpfpfpfpnwqEsDAlaCfpcIlZlZlZlZlZlZlZlZlZlZlZlZlZlZlZlZlZlZlZlZlZlZlZlZlZlZlZlZlZlZlZlZlZlZlZlZlZlZlZlZlZlZlZ
lZlZlZlZlZlZlZlZlZlZlZlZlZlZlZlZvyutNsNsNsNsNsNsNsNsNsNsNsxunXWNXVmWfxfpfpfpfpfpnwqEsDAlaCfpcIlZlZlZlZlZlZlZlZlZlZlZlZlZlZlZlZlZlZlZlZlZlZlZlZlZlZlZlZlZlZlZlZlZlZlZlZlZlZlZlZlZlZlZ
lZlZlZlZlZlZlZlZlZlZlZlZlZlZlZlZvyutNsNsNsNsNsNsNsNsNsNsNsxunXWNXVmWfxfpfpfpfpfpnwqEsDAlaCfpcIlZlZlZlZlZlZlZlZlZlZlZlZlZlZlZlZlZlZlZlZlZlZlZlZlZlZlZlZlZlZlZlZlZlZlZlZlZlZlZlZlZlZlZ
lZlZlZlZlZlZlZlZlZlZlZlZlZlZlZlZvyutNsNsNsNsNsNsNsNsNsNsNsBXjkokXVmWfxfpfpfpfpfpnwqEsDAlaCfpcIlZlZlZlZlZlZlZlZlZlZlZlZlZlZlZlZlZlZlZlZlZlZlZlZlZlZlZlZlZlZlZlZlZlZlZlZlZlZlZlZlZlZlZ
lZlZlZlZlZlZlZlZlZlZlZlZlZlZlZlZvyutNsNsNsNsNsNsNsNsNsNsNsNsNsNsXVmWfxfpfpfpfpfpnwqEsDAlaCfpcIlZlZlZlZlZlZlZlZlZlZlZlZlZlZlZlZlZlZlZlZlZlZlZlZlZlZlZlZlZlZlZlZlZlZlZlZlZlZlZlZlZlZlZ
lZlZlZlZlZlZlZlZlZlZlZlZlZlZlZlZvyutNsNsNsNsNsNsNsNsNsNsocpepepeCVmWEHdhdhdhdhdheHyvsDAlaCfpcIlZlZlZlZlZlZlZlZlZlZlZlZlZlZlZlZlZlZlZlZlZlZlZlZlZlZlZlZlZlZlZlZlZlZlZlZlZlZlZlZlZlZlZ
lZlZlZlZlZlZlZlZlZlZlZlZlZlZlZlZvyutNsNsNsNsNsNsNsNsNsNsXVmWmWmWmWmWsDsDsDsDsDsDIisDsDAlaCfpcIlZlZlZlZlZlZlZlZlZlZlZlZlZlZlZlZlZlZlZlZlZlZlZlZlZlZlZlZlZlZlZlZlZlZlZlZlZlZlZlZlZlZlZ
lZlZlZlZlZlZlZlZlZlZlZlZlZlZlZlZvyggpepepepepepepepepepeCVmWQLZPZPZPZPZPZPZPZPZPqymbmbmbqcfpcIlZlZlZlZlZlZlZlZlZlZlZlZlZlZlZlZlZlZlZlZlZlZlZlZlZlZlZlZlZlZlZlZlZlZlZlZlZlZlZlZlZlZlZ
lZlZlZlZlZlZlZlZlZlZlZlZlZlZlZlZJecjmWmWmWmWmWmWmWmWmWmWmWmWaCcIcIcIcIcIcIcIcIcIcIcIcIcIIFcIcIlZlZlZlZlZlZlZlZlZlZlZlZlZlZlZlZlZlZlZlZlZlZlZlZlZlZlZlZlZlZlZlZlZlZlZlZlZlZlZlZlZlZlZ
lZlZlZlZlZlZlZlZlZlZlZlZlZlZlZlZcIDIZPZPZPZPZPZPZPZPZPZPZPZPqccIfpfpfpfpfpfpfpfpfpfpfpfpfpcIlZlZlZlZlZlZlZlZlZlZlZlZlZlZlZlZlZlZlZlZlZlZlZlZlZlZlZlZlZlZlZlZlZlZlZlZlZlZlZlZlZlZlZlZ
lZlZlZlZlZlZlZlZlZlZlZlZlZlZlZlZcIcIcIcIfpfpfpcIcIcIcIcIfpfpfpoTfpfpfpfpfpfpfpfpfpfpfpfpfpcIlZlZlZlZlZlZlZlZlZlZlZlZlZlZlZlZlZlZlZlZlZlZlZlZlZlZlZlZlZlZlZlZlZlZlZlZlZlZlZlZlZlZlZlZ
lZlZlZlZlZlZlZlZlZlZlZlZlZlZlZlZcIqyqycIfpfpfpcIqyqyqycIfpfpfpcIfpfpfpfpfpfpfpfpfpfpfpfpfpcIlZlZlZlZlZlZlZlZlZlZlZlZlZlZlZlZlZlZlZlZlZlZlZlZlZlZlZlZlZlZlZlZlZlZlZlZlZlZlZlZlZlZlZlZ
lZlZlZlZlZlZlZlZlZlZlZlZlZlZlZlZcIcIcIcIcIoTcIcIcIcIcIcIcIoTcIcIcIcIcIcIcIcIcIcIcIcIcIcIcIcIlZlZlZlZlZlZlZlZlZlZlZlZlZlZlZlZlZlZlZlZlZlZlZlZlZlZlZlZlZlZlZlZlZlZlZlZlZlZlZlZlZlZlZlZ
lZlZlZlZlZlZlZlZlZlZlZlZlZlZlZlZlZlZcIcIfpfpfpcIcIlZcIcIfpfpfpcIcIlZlZlZlZlZlZlZlZlZlZlZlZlZlZlZlZlZlZlZlZlZlZlZlZlZlZlZlZlZlZlZlZlZlZlZlZlZlZlZlZlZlZlZlZlZlZlZlZlZlZlZlZlZlZlZlZlZ
lZlZlZlZlZlZlZlZlZlZlZlZlZlZlZlZlZlZlZcIWVWVWVcIlZlZlZcIJIJIJIcIlZlZlZlZlZlZlZlZlZlZlZlZlZlZlZlZlZlZlZlZlZlZlZlZlZlZlZlZlZlZlZlZlZlZlZlZlZlZlZlZlZlZlZlZlZlZlZlZlZlZlZlZlZlZlZlZlZlZ
lZlZlZlZlZlZlZlZlZlZlZlZlZlZlZlZlZlZlZcIqyqyqycIlZlZlZcIqyqyqycIlZlZlZlZlZlZlZlZlZlZlZlZlZlZlZlZlZlZlZlZlZlZlZlZlZlZlZlZlZlZlZlZlZlZlZlZlZlZlZlZlZlZlZlZlZlZlZlZlZlZlZlZlZlZlZlZlZlZ
lZlZlZlZlZlZlZlZlZlZlZlZlZlZlZlZlZlZlZcIqyqyqycIlZlZlZcIqyqyqycIlZlZlZlZlZlZlZlZlZlZlZlZlZlZlZlZlZlZlZlZlZlZlZlZlZlZlZlZlZlZlZlZlZlZlZlZlZlZlZlZlZlZlZlZlZlZlZlZlZlZlZlZlZlZlZlZlZlZ
lZlZlZlZlZlZlZlZlZlZlZlZlZlZlZlZlZlZlZlZZTlZlZlZlZlZlZlZZTlZlZlZlZlZlZlZlZlZlZlZlZlZlZlZlZlZlZlZlZlZlZlZlZlZlZlZlZlZlZlZlZlZlZlZlZlZlZlZlZlZlZlZlZlZlZlZlZlZlZlZlZlZlZlZlZlZlZlZlZlZ
lZlZlZlZlZlZlZlZlZlZlZlZlZlZlZlZlZlZlZlZlZlZlZlZlZlZlZlZlZlZlZlZlZlZlZlZlZlZlZlZlZlZlZlZlZlZlZlZlZlZlZlZlZlZlZlZlZlZlZlZlZlZlZlZlZlZlZlZlZlZlZlZlZlZlZlZlZlZlZlZlZlZlZlZlZlZlZlZlZlZ
lZlZlZlZlZlZlZlZlZlZlZlZlZlZlZlZlZlZlZlZlZlZlZlZlZlZlZlZlZlZlZlZlZlZlZlZlZlZlZlZlZlZlZlZlZlZlZlZlZlZlZlZlZlZlZlZlZlZlZlZlZlZlZlZlZlZlZlZlZlZlZlZlZlZlZlZlZlZlZlZlZlZlZlZlZlZlZlZlZlZ
lZlZlZlZlZlZlZlZlZlZlZlZlZlZlZlZlZlZlZlZlZlZlZlZlZlZlZlZlZlZlZlZlZlZlZlZlZlZlZlZlZlZlZlZlZlZlZlZlZlZlZlZlZlZlZlZlZlZlZlZlZlZlZlZlZlZlZlZlZlZlZlZlZlZlZlZlZlZlZlZlZlZlZlZlZlZlZlZlZlZ
lZlZlZlZlZlZlZlZlZlZlZlZlZlZlZlZlZlZlZlZlZlZlZlZlZlZlZlZlZlZlZlZlZlZlZlZlZlZlZlZlZlZlZlZlZlZlZlZlZlZlZlZlZlZlZlZlZlZlZlZlZlZlZlZlZlZlZlZlZlZlZlZlZlZlZlZlZlZlZlZlZlZlZlZlZlZlZlZlZlZ
lZlZlZlZlZlZlZlZlZlZlZlZlZlZlZlZlZlZlZlZlZlZlZlZlZlZlZlZlZlZlZlZlZlZlZlZlZlZlZlZlZlZlZlZlZlZlZlZlZlZlZlZlZlZlZlZlZlZlZlZlZlZlZlZlZlZlZlZlZlZlZlZlZlZlZlZlZlZlZlZlZlZlZlZlZlZlZlZlZlZ
lZlZlZlZlZlZlZlZlZlZlZlZlZlZlZlZlZlZlZlZlZlZlZlZlZlZlZlZlZlZlZlZlZlZlZlZlZlZlZlZlZlZlZlZlZlZlZlZlZlZlZlZlZlZlZlZlZlZlZlZlZlZlZlZlZlZlZlZlZlZlZlZlZlZlZlZlZlZlZlZlZlZlZlZlZlZlZlZlZlZ
lZlZlZlZlZlZlZlZlZlZlZlZlZlZlZlZlZlZlZlZlZlZlZlZlZlZlZlZlZlZlZlZlZlZlZlZlZlZlZlZlZlZlZlZlZlZlZlZlZlZlZlZlZlZlZlZlZlZlZlZlZlZlZlZlZlZlZlZlZlZlZlZlZlZlZlZlZlZlZlZlZlZlZlZlZlZlZlZlZlZ
lZlZlZlZlZlZlZlZlZlZlZlZlZlZlZlZlZlZlZlZlZlZlZlZlZlZlZlZlZlZlZlZlZlZlZlZlZlZlZlZlZlZlZlZlZlZlZlZlZlZlZlZlZlZlZlZlZlZlZlZlZlZlZlZlZlZlZlZlZlZlZlZlZlZlZlZlZlZlZlZlZlZlZlZlZlZlZlZlZlZ
lZlZlZlZlZlZlZlZlZlZlZlZlZlZlZlZlZlZlZlZlZlZlZlZlZlZlZlZlZlZlZlZlZlZlZlZlZlZlZlZlZlZlZlZlZlZlZlZlZlZlZlZlZlZlZlZlZlZlZlZlZlZlZlZlZlZlZlZlZlZlZlZlZlZlZlZlZlZlZlZlZlZlZlZlZlZlZlZlZlZ
lZlZlZlZlZlZlZlZlZlZlZlZlZlZlZlZlZlZlZlZlZlZlZlZlZlZlZlZlZlZlZlZlZlZlZlZlZlZlZlZlZlZlZlZlZlZlZlZlZlZlZlZlZlZlZlZlZlZlZlZlZlZlZlZlZlZlZlZlZlZlZlZlZlZlZlZlZlZlZlZlZlZlZlZlZlZlZlZlZlZ
lZlZlZlZlZlZlZlZlZlZlZlZlZlZlZlZlZlZlZlZlZlZlZlZlZlZlZlZlZlZlZlZlZlZlZlZlZlZlZlZlZlZlZlZlZlZlZlZlZlZlZlZlZlZlZlZlZlZlZlZlZlZlZlZlZlZlZlZlZlZlZlZlZlZlZlZlZlZlZlZlZlZlZlZlZlZlZlZlZlZ
lZlZlZlZlZlZlZlZlZlZlZlZlZlZlZlZlZlZlZlZlZlZlZlZlZlZlZlZlZlZlZlZlZlZlZlZlZlZlZlZlZlZlZlZlZlZlZlZlZlZlZlZlZlZlZlZlZlZlZlZlZlZlZlZlZlZlZlZlZlZlZlZlZlZlZlZlZlZlZlZlZlZlZlZlZlZlZlZlZlZ
lZlZlZlZlZlZlZlZlZlZlZlZlZlZlZlZlZlZlZlZlZlZlZlZlZlZlZlZlZlZlZlZlZlZlZlZlZlZlZlZlZlZlZlZlZlZlZlZlZlZlZlZlZlZlZlZlZlZlZlZlZlZlZlZlZlZlZlZlZlZlZlZlZlZlZlZlZlZlZlZlZlZlZlZlZlZlZlZlZlZ
lZlZlZlZlZlZlZlZlZlZlZlZlZlZlZlZlZlZlZlZlZlZlZlZlZlZlZlZlZlZlZlZlZlZlZlZlZlZlZlZlZlZlZlZlZlZlZlZlZlZlZlZlZlZlZlZlZlZlZlZlZlZlZlZlZlZlZlZlZlZlZlZlZlZlZlZlZlZlZlZlZlZlZlZlZlZlZlZlZlZ
lZlZlZlZlZlZlZlZlZlZlZlZlZlZlZlZlZlZlZlZlZlZlZlZlZlZlZlZlZlZlZlZlZlZlZlZlZlZlZlZlZlZlZlZlZlZlZlZlZlZlZlZlZlZlZlZlZlZlZlZlZlZlZlZlZlZlZlZlZlZlZlZlZlZlZlZlZlZlZlZlZlZlZlZlZlZlZlZlZlZ
"}
